11111110
11111111
00100011
00100011
00100011